ABNT - Associação Brasileira de Normas Técnicas
ADC - Apoio à Difusão do Conhecimento
AGU - Advocacia Geral da União
APAE - Associação de Pais e Amigos dos Excepcionais 
ARPANET - Advanced Research Projects Agency Network
ATP - Bolsa de Apoio Técnico em Extensão no País  
BAOBAXIA - Baobá nas Galáxias
BBC - British Broadcasting Corporation
BBN - Bolt, Beranek and Newman Inc
BDR - Banco de Dados Relacional	
BPMN - Business Process Modelling Notation
CAI - Computed Aid instruction
CBT - Cubatão
CCVB - Ciência e Cultura, Vamos Brincar?
CEGE - Comitê Executivo de Governo Eletrônico
CEI - Centro de Educação Infantil
CEMADEN - Centro Nacional de Monitoramento de Desastres Naturais
CERTI - Centro de Referências em Tecnologias Inovadoras
CGEE - Centro de Gestão e Estudos Estratégicos
CIN - Centro Integrado de Nefrologia da Unicamp
CJO - Campos do Jordão
CMP - Campinas
CNPq - Conselho Nacional de Desenvolvimento Científico e Tecnológico
CRS - Congressional Research Service
CT - Centro de Treinamento
CTI - Centro de Tecnologia da Informação Renato Archer
DESID- Departamento de Inclusão Digital 
DF - Distrito Federal
DOU - Diário Oficial da União
DT - Bolsa de Desenvolvimento Tecnológico
DTI -  Bolsa de Desenvolvimento Tecnológico e Industrial
EBC - Empresa Brasileira de Comunicação
EESC Escola de Engenharia de São Carlos
EF - Ensino Fundamental
EMEF - Escola Municipal de Ensino Fundamental
EMEFI -  Escola Municipal de Ensino Fundamental e Infantil
EMEI - Escola Municipal de Ensino Infantil
EMEIF - Escola Municipal de Ensino Infantil e Fundamental
ENAP - Escola Nacional de Administração Pública
ENCTI - Estratégia Nacional de Ciência, Tecnologia e Inovação
ESTEEM - Environment, Science, Technology Engineering, Expression and Mathematics
ETEC - Escola Técnica Estadual
EUA - Estados Unidos da América
EXP - Bolsas de Fomento Tecnológico e Extensão Inovadora
FAPESP - Fundação de Amparo à Pesquisa do Estado de São Paulo
FHC -  Fernando Henrique Cardoso
FUNBOSQUE - Fundação Escola do Bosque
FUNDEB - Fundo de Manutenção e Desenvolvimento da Educação Básica
GESAC- Governo Eletrônico de Serviço de Atendimento ao Cidadão 
GNU - GNU is not UNIX
GNU/LINUX - Unix like Kernel linux
GPS - Global Positioning System
HTML - Linguagem de  Marcação de Hipertexto 
IBGE - Instituto Brasileiro de Geografia e Estatística
IBM - International Business Machines
ICANN - Internet Corporation for Assigned Names and Numbers
IC - Iniciação Científica
ICMC - Instituto de Ciências Matemáticas e de Computação 
IEEE - Instituto de Engenheiros Eletricistas e Eletrônicos
IF - Instituto Federal
IFPR - Instituto Federal do Paraná
IFSC - Instituto Federal de Santa Catarina
IFSP - Instituto Federal de Educação, Ciência e Tecnologia São Paulo Campus Campinas
INPI - Instituto Nacional de Propriedade Industrial
ISSN - Internacional Standard Serial Number
ITA - Instituto de Tecnologia Aeronáutica
ITI - Instituteo de Tecnologia da Informação
IT - Information Technology
IT in Government - Tecnologia da Informação no Governo
JPG - Joint Photographics Experts Groups
LBL - Lawrence Berkeley Lab
LGPD - Lei Geral de Proteção de Dados
MAAS - Museu Aberto de Astronomia de Campinas
MA - Maranhão
MC - Ministério das Comunicações
MCTI - Ministério da Ciência, Tecnologia e Inovações
MCT - Ministério da Ciência e Tecnologia
MDIC - Ministério do Desenvolvimento da Indústria e Comércio
MD - Modelagem de Dados
MEC - Ministério da Educação
MER - Modelo Entidade Relacionamento
METS - Sigla alternativa a STEM
MINITEL - Serviço de VídeoTexto da França
MIT - Massachusetts Institute of Technology
MSTL -  Movimento Sem Terra de Luta
MULTCAST - Protocolo que transmite pacotes eficientemente para múltiplos pontos distintos,
NBR - Norma Brasileira
NC - North Carolina
NSF - National Science Foundation
NVU - Web Authoring System for Linux Desktop, Microsoft Windows and Macintosh
OCDE - Organização para a Cooperação e Desenvolvimento Econômico
OLPC - One Laptop per Child 
ONGS - Organizações não-governamentais
ONU - Organização das Nações Unidas
OSM - Organização, Sistemas e Métodos
PB - Paraíba
PCI - Programa de Capacitação Institucional
PC - Personal Computer
PDF - Portable Document Format
PHP - Hypertext Preprocessor
PID ou PIDS - Programa de Inclusão Digital da SECIS do MCTI
PI - Piauí
PISA - Programa Internacional de avaliação de alunos
PIX - Plataforma de pagamento eletrônico
PLDO - Projeto de Lei de Diretrizes Orçamentárias
PLOA - Projeto de Lei Orçamentária Anual
PMI - Project Management Institute
PPs - Pontos de Presença 
PQ - Bolsa de Pesquisa
PROINFO - Programa Nacional de Tecnologia Educacional
PR - Paraná
PS- Primeiras séries
PS - Pronto Socorro
PUC - Pontifícia Universidade Católica
RAU - Rede de Atendimento de urgência
REL - Grupo de Relacionamento com as Comunidades do GESAC
RGB - Red, Green and Blue
RG - Registro Geral
RN - Rio Grande do Norte
SCRATCH - Linguagem de programação que sucedeu o LOGO
SC - Santa Catarina
SECIS - Secretaria de Inclusão Social do MCTI
SEI - Sistema de documentação digital do Governo Federal
SENAC - Serviço Nacional do Comércio
SENGEN -  Semana da Engenharia do Campus do Mucuri
SEPPIR - Secretaria Nacional de Promoção de Politicar de Igualdade Racial
SERPRO - Serviço Federal de Processamento de Dados
SIDRA - Sistema IBGE de Recuperação Automática
SJC - São José dos Campos
SLTI -  Secretaria de Logística e Tecnologia da Informação 
SLT -  Secretaria de Logística e Transportes
SMET - Equivalente a STEM
SP - São Paulo
SQL - Structured Query Language
STEAM - Science, Technology, Engineering, Arts and Mathematics
STEM -  Science, Technology, Engineering and Mathematics
TA - Tecnologia Assistiva
TC - Antonio Carlos de Santos Silva
TCC - Trabalho de conclusão de curso
TELESP- Telecomunicações de São Paulo
TICS - Tecnologias de Informação e Comunicação
TIC - Tecnologia de Informação e Comunicação
TI - Tecnologia da Informação
TN - Todos os níveis
TVE - Televisão Educativa
TV - Televisão
TVT - Televisão do Trabalhador
UCA - Um Computador por Aluno
UFABC - Universidade Federal do ABC 
UNB - Universidade de Brasília
UNESCO - Organização das Nações Unidas para a Educação, a Ciência e a Cultura  
UNESP - Univesidade Estadual Paulista
UNICAMP - Universidade Estadual de Campinas
UNIFESP - Universidade Federal de São Paulo
URL - Uniform Resource Locator
USA - United States of America
USP - Universidade de São Paulo
USS - United States Navy
UTFPR - Universidade Tecnológica Federal do Paraná
VOIP - Voz sobre IP
VRT - Canal de TV interativa
VSAT - Very Small Aperture Terminal
WASH - Workshop de Aficionados em Software e Hardware
